одно	иное	1
иное	одно	1
бытие	ничто	2
ничто	бытие	2
1	не_1	2
не_1	1	2
становление	иное_становлению	3
иное_становлению	становление	3
инкремент	декремент	3
декремент	инкремент	3
2	не_2	3
не_2	2	3
возникновение	прехождение	4
прехождение	возникновение	4
3	не_3	4
не_3	3	4
наличное_бытие	иное_наличному_бытию	5
иное_наличному_бытию	наличное_бытие	5
4	не_4	5
не_4	4	5
больше_3х	до_3х_включительно	5
до_3х_включительно	больше_3х	5
определение	свойство	6
свойство	определение	6
увеличение	уменьшение	6
уменьшение	увеличение	6
операция	данные	6
данные	операция	6
изделие_полученное_обработкой	заготовка_для_обработки	6
заготовка_для_обработки	изделие_полученное_обработкой	6
присутствие	отсутствие	6
отсутствие	присутствие	6
граница	иное_границы	7
иное_границы	граница	7
логическая_операция	нелогическая_операция	7
нелогическая_операция	логическая_операция	7
соединение_частей	разделение_на_части	7
разделение_на_части	соединение_частей	7
обработка_резанием	обработка_штамповкой	7
обработка_штамповкой	обработка_резанием	7
деталь	сборка	7
сборка	деталь	7
конечное	иное_конечному	8
иное_конечному	конечное	8
логическое_и	логическое_либо	8
логическое_либо	логическое_и	8
сверление	фрезерование	8
фрезерование	сверление	8
штамповка	не_штамповка	8
не_штамповка	штамповка	8
класс_74_ОК_ЕСКД	класс_не_74_ОК_ЕСКД	8
класс_не_74_ОК_ЕСКД	класс_74_ОК_ЕСКД	8
бесконечное	иное_бесконечному	9
иное_бесконечному	бесконечное	9
логическое_либо_треугольник_иное	логическое_либо_не_треугольник_иное	9
логическое_либо_не_треугольник_иное	логическое_либо_треугольник_иное	9
логическое_либо_криволинейная_иное	логическое_либо_не_криволинейная_иное	9
логическое_либо_не_криволинейная_иное	логическое_либо_криволинейная_иное	9
подкласс_741_ОК_ЕСКД	подкласс_не_741_ОК_ЕСКД	9
подкласс_не_741_ОК_ЕСКД	подкласс_741_ОК_ЕСКД	9
количество	иное_количеству	10
иное_количеству	количество	10
логическое_либо_треугольник_четырехугольник	логическое_либо_треугольник_не_четырехугольник	10
логическое_либо_треугольник_не_четырехугольник	логическое_либо_треугольник_четырехугольник	10
логическое_либо_криволинейная_комбинированная_выпуклая_иное	логическое_либо_криволинейная_не_комбинированная_выпуклая_иное	10
логическое_либо_криволинейная_не_комбинированная_выпуклая_иное	логическое_либо_криволинейная_комбинированная_выпуклая_иное	10
группа_7411_ОК_ЕСКД	группа_не_7411_ОК_ЕСКД	10
группа_не_7411_ОК_ЕСКД	группа_7411_ОК_ЕСКД	10
группа_7413_ОК_ЕСКД	группа_не_7413_ОК_ЕСКД	10
группа_не_7413_ОК_ЕСКД	группа_7413_ОК_ЕСКД	10
величина	иное_величине	11
иное_величине	величина	11
сложение	вычитание	11
вычитание	сложение	11
габарит	иное_габариту_количественное_свойство	11
иное_габариту_количественное_свойство	габарит	11
логическое_либо_криволинейная_комбинированная_выпуклая_комбинированная_вогнутая	логическое_либо_не_криволинейная_комбинированная_выпуклая_комбинированная_вогнутая	11
логическое_либо_не_криволинейная_комбинированная_выпуклая_комбинированная_вогнутая	логическое_либо_криволинейная_комбинированная_выпуклая_комбинированная_вогнутая	11
число	иное_числу	12
иное_числу	число	12
умножение	деление	12
деление	умножение	12
множество	иное_множеству	13
иное_множеству	множество	13
равенство	неравенство	13
неравенство	равенство	13
рефлексия	иное_рефлексии	14
иное_рефлексии	рефлексия	14
геометрическое_пространство	не_геометрическое_пространство	14
не_геометрическое_пространство	геометрическое_пространство	14
перечислимое_множество	неперечислимое_множество	14
неперечислимое_множество	перечислимое_множество	14
множество_прямых	множество_кривых	14
множество_кривых	множество_прямых	14
множество_плоских_поверхностей	множество_неплоских_поверхностей	14
множество_неплоских_поверхностей	множество_плоских_поверхностей	14
тождество	различие	15
различие	тождество	15
положенность	неположенность	16
неположенность	положенность	16
топос	иное_топосу	16
иное_топосу	топос	16
одинаковость	неодинаковость	17
неодинаковость	одинаковость	17
движение	покой	17
покой	движение	17
противоположность	иное_противоположности	18
иное_противоположности	противоположность	18
линия	иное_линиие	18
иное_линиие	линия	18
перечисление	неперечислимость	18
неперечислимость	перечисление	18
поверхность	иное_поверхности	18
иное_поверхности	поверхность	18
вращение	иное_вращению	18
иное_вращению	вращение	18
пресс	иное_прессу	18
иное_прессу	пресс	18
положительное	отрицательное	19
отрицательное	положительное	19
прямая	кривая	19
кривая	прямая	19
отрезок	неограниченная_линия	19
неограниченная_линия	отрезок	19
плоскость	неплоская_поверхность	19
неплоская_поверхность	плоскость	19
противоречие	иное_противоречию	20
иное_противоречию	противоречие	20
замкнутая_линия	иное_замкнутой_линии	20
иное_замкнутой_линии	замкнутая_линия	20
ломаная_линия	неперечислимое_множество_отрезков	20
неперечислимое_множество_отрезков	ломаная_линия	20
основание	иное_основанию	21
иное_основанию	основание	21
окружность	иное_окружности	21
иное_окружности	окружность	21
многоугольник	линия_с_неперечилимым_множеством_сторон	21
линия_с_неперечилимым_множеством_сторон	многоугольник	21
материя	форма	22
форма	материя	22
сторона_многоугольника	неэлементарная_часть_многоугольника	22
неэлементарная_часть_многоугольника	сторона_многоугольника	22
треугольник	не_треугольник	22
не_треугольник	треугольник	22
четырехугольник	не_четырехугольник	22
не_четырехугольник	четырехугольник	22
криволинейная	не_криволинейная	22
не_криволинейная	криволинейная	22
содержание	иное_содержанию	23
иное_содержанию	содержание	23
выпуклая	иное_выпуклая	23
иное_выпуклая	выпуклая	23
вогнутая	иное_вогнутая	23
иное_вогнутая	вогнутая	23
условие	обусловленное	24
обусловленное	условие	24
комбинированная_выпуклая	иное_комбинированная_выпуклая	24
иное_комбинированная_выпуклая	комбинированная_выпуклая	24
комбинированная_вогнутая	иное_комбинированная_вогнутая	24
иное_комбинированная_вогнутая	комбинированная_вогнутая	24
отношение	иное_отношению	25
иное_отношению	отношение	25
комбинированная_вогнутая_с_переодически_повторяющимися_элементами_контура_с_элементами_криволинейного_контура	комбинированная_вогнутая_без_переодически_повторяющихся_элементов_контура_типа_гребенок	25
комбинированная_вогнутая_без_переодически_повторяющихся_элементов_контура_типа_гребенок	комбинированная_вогнутая_с_переодически_повторяющимися_элементами_контура_с_элементами_криволинейного_контура	25
целое	часть	26
часть	целое	26
отношение_на_множестве_прямых	отношение_на_множестве_кривых	26
отношение_на_множестве_кривых	отношение_на_множестве_прямых	26
отношение_на_множестве_плоскостей	отношение_на_множестве_неплоских_поверхностей	26
отношение_на_множестве_неплоских_поверхностей	отношение_на_множестве_плоскостей	26
отношение_по_величине	отношение_не_по_величине	26
отношение_не_по_величине	отношение_по_величине	26
отношение_частей_габарита	отношение_не_габаритых_параметров	26
отношение_не_габаритых_параметров	отношение_частей_габарита	26
внутреннее	внешнее	27
внешнее	внутреннее	27
элемент	неэлементарная_часть	27
неэлементарная_часть	элемент	27
конструктивный_элемент_детали	часть_сборки	27
часть_сборки	конструктивный_элемент_детали	27
параллельность_прямых	непараллельность_прямых	27
непараллельность_прямых	параллельность_прямых	27
параллельность_плоскостей	непараллельность_плоскостей	27
непараллельность_плоскостей	параллельность_плоскостей	27
параллельность_неплоских_поверхностей	непараллельность_неплоских_поверхностей	27
непараллельность_неплоских_поверхностей	параллельность_неплоских_поверхностей	27
больше	меньше	27
меньше	больше	27
l_до_3в_включ	l_св_3в	27
l_св_3в	l_до_3в_включ	27
взаимодйствие	противостояние	28
противостояние	взаимодйствие	28
внешний_элемент_детали	внутренний_элемент_детали	28
внутренний_элемент_детали	внешний_элемент_детали	28
резьба	без_резьбы	28
без_резьбы	резьба	28
непараллельность_2х_прямых	непараллельность_не_2х_прямых	28
непараллельность_не_2х_прямых	непараллельность_2х_прямых	28
отверстие	внутренний_элемент_не_отверстие	29
внутренний_элемент_не_отверстие	отверстие	29
числовая_величина_угла	нечисловое_свойство_угла	29
нечисловое_свойство_угла	числовая_величина_угла	29
с_отверстиями	без_отверстий	30
без_отверстий	с_отверстиями	30
углы_равны	углы_неравны	30
углы_неравны	углы_равны	30
прямой_угол	непрямой_угол	30
непрямой_угол	прямой_угол	30
с_отверстиями_одного_типа	с_отверстиями_разных_типов	31
с_отверстиями_разных_типов	с_отверстиями_одного_типа	31
с_отверстиями_круглыми	с_отверстиями_некруглыми	32
с_отверстиями_некруглыми	с_отверстиями_круглыми	32
с_отверстиями_круглыми_и_некруглыми	с_отверстиями_со_свойствами_иными_форме	32
с_отверстиями_со_свойствами_иными_форме	с_отверстиями_круглыми_и_некруглыми	32